111111111111111111111111111111
1P0000C0000000011110000B000001
101111111011111000101111111101
100000000010000000001000000001
101111101111101111111011101101
1C0000100000010000B00000000C01
111101110111101111101111111101
100001000010000000000000000001
101111101011111011111111101101
1C000000000000C000000000C00001
101111111011111011111111111101
1000000B001000B000000010000001
101111101111101111101111111101
1C000000000C0000000000000000C1
101110111111110111111011101101
1000000000B00000000B00000000E1
111111111111111111111111111111
