111111111111111111111111111111
1P0000B000C000B000111100B0C001
111101111111111111111111111101
1000000C000000B000010000000001
111111111111111101111111111101
1B00000000CB0000C00000C00000C1
111111111111111111111111111101
1000000C0000000000000000000001
111111101011111111011111111111
1C0B00C0000000C0000B00C0B000C1
111111111111111111111111111101
1B0000B0000000000C0000B0000001
111111111111111111111111111101
1000C0C0000C0B00C0000C000000C1
111111111111111111111111111101
1000000B0000C0000B0000C00000E1
111111111111111111111111111111
