111111111111111111111111111111
100000B000C000B0001111000000B1
111111111111111110111111111101
1000000C0000000P00010000000001
111111111011111111111111111101
1B0000C0000B0000C00000C00000C1
111111111111111111111111111101
1000000C0000000000000000000001
111111101011111111111111111111
1C0000C0000000C0000000C00000C1
111111111111111111111111111101
1B0000B0000C0000000000B0000001
111111111111111111111111111101
1C0000C0000C0000C0000C000000C1
111111111111111111111111111101
1000000B0000C0000B0000C00000E1
111111111111111111111111111111
