111111111111111111111111111111
1P0000000C0000001111000000B001
101111111011111000111111111101
100000000000000000000000000001
111101110111111111111011111101
1C0000B00000100000C0000B000C01
101111111111101111101111111101
100000001000010000000000000001
111111101011111011111111101101
1C000C000000000C000000000C0001
101111111011111011111111111101
1000B0000001000B00000000000001
101111101111101111111111111101
1C000000000C000000000C000000C1
111111111111110111111111111101
1C000000000B0000000000000000E1
111111111111111111111111111111
