111111111111111111111111111111
1P00000000C0000011110000000001
101111111010111100001011111101
100000000010000000001000000001
111101111011111011111011101101
1C001000000001000000000000C001
101101111110111101111011111101
101001000000000001000000000001
101011111011111101011101111101
100000001000C00000010000000001
101110111110111111101111111101
101000000010000000001000000001
101011111011101111101011111101
1C0000000000000000000000C00001
101111011111110111111011101101
100000000000000C000000000000E1
111111111111111111111111111111
