11111111111
10P00000001
10000000C01
100E0000001
11111111111
