11111111111111111
1000000000C00C001
10111100001010001
1P1111010100100E1
1000000C000000101
10111100001010001
10111101010010001
10111100001010001
1C111101010010001
101111000C1010001
10111101010010001
11111111111111111
