1111111111111111111111111111111
1000000000000000C00000C00000001
1011110100100000101001000000011
1011110010101010001001000000011
1P0000000C00C000000000001010001
1E11110100100000101001000000011
1011110010101010001001000000011
1011110100100000101001000000011
1C11110010101010001001000000011
10111101001000C0101001000000011
101111001010101000100100C000011
1111111111111111111111111111111
