11111111111111111
1CCCCCCCCCCCCCCP1
1BCCCCCCCCCCCCCC1
1CCCCCCCCCCCCCCC1
1CCCCCCCCCCCCCCC1
1CCCCCCCCCCCCCCC1
1CCCCCCCCCCCCCCC1
1CCCCCCCCCCCCCCC1
1CCCCCCCCCCCCCCC1
1CCCCCCCCCCCCCCC1
1CCCCCCCCCCCCCCE1
11111111111111111
