1111111111111111111111111111111
1000000000000000C00000C00000001
1011110100100000101001000B00011
1P11110010101010001001000000011
100000000C00C0000000000B1010001
1E11110100100000101001000000011
1011110010101010001001000000011
1011110100100000101001000000011
1C11110010101010001001000B00001
10111101001000CB101001000000011
101111001010101000100100C000011
1111111111111111111111111111111
