1111111111111
10010000000C1
1000011111001
10010000000C1
1000011111001
1P001100E0001
1010000001111
1000011111111
1111111111111
